30
1 1 1 1 1 1 1 1 1 1 1 1 1 1 1 1 1 1 1 1 1 1 1 1 1 1 1 1 1 1
1 2 2 1 1 2 2 2 2 2 2 2 2 2 2 2 2 2 2 2 2 2 2 1 1 2 1 1 2 1
1 2 2 1 1 2 2 1 1 2 2 2 2 2 1 1 2 2 1 1 1 1 2 1 1 2 1 1 2 1
1 2 2 2 2 2 2 1 1 2 1 1 2 2 1 1 2 2 1 1 1 1 2 1 1 2 1 1 2 1
1 1 1 2 1 1 2 2 2 2 1 1 2 2 2 2 2 2 2 2 2 2 2 2 2 2 1 1 2 1
1 1 1 2 1 1 2 2 2 2 1 1 2 1 1 2 2 2 1 1 1 2 2 2 2 2 2 2 2 1
1 2 2 2 1 1 2 2 2 2 2 2 2 1 1 2 2 2 1 1 1 2 1 1 2 2 1 1 2 1
1 2 2 2 2 2 2 2 2 2 2 2 2 2 2 2 2 2 1 1 1 2 1 1 2 2 1 1 2 1
1 2 2 2 1 1 1 1 2 2 2 2 2 2 2 2 2 2 1 1 1 2 2 2 2 2 2 2 2 1
1 2 2 2 1 1 1 1 2 2 2 2 1 1 1 1 2 2 2 2 2 2 2 2 2 2 1 1 2 1
1 2 2 2 1 1 1 1 2 2 2 2 1 1 1 1 2 2 2 2 2 2 2 2 2 2 1 1 2 1
1 2 2 2 2 2 2 2 2 2 2 2 1 1 1 1 2 2 2 2 2 2 1 1 1 2 1 1 2 1
1 2 2 2 2 2 1 1 1 1 2 2 1 1 1 1 2 2 2 1 1 2 1 1 1 2 1 1 2 1
1 2 2 2 2 2 1 1 1 1 7 5 6 2 2 2 2 2 2 1 1 2 1 1 1 2 2 2 2 1
1 2 2 2 2 2 1 1 1 1 2 2 1 1 1 2 2 2 2 2 2 2 2 2 2 2 2 2 2 1
1 1 1 1 2 2 1 1 1 1 0 2 1 1 1 2 2 2 2 2 2 2 2 2 2 2 2 2 2 1
1 1 1 1 2 2 2 2 2 2 2 2 1 1 1 2 2 2 2 2 2 2 2 2 2 2 2 2 2 1
1 2 2 2 2 2 2 2 2 2 2 2 1 1 1 2 2 1 1 1 2 1 1 1 2 2 2 2 2 1
1 1 1 2 2 2 2 2 2 2 2 2 2 2 2 2 2 1 1 1 2 1 1 1 2 1 1 1 1 1
1 1 1 2 1 1 1 1 2 2 2 2 2 2 1 1 2 2 2 2 2 1 1 1 2 1 1 1 1 1
1 2 2 2 1 1 1 1 2 1 1 1 1 2 1 1 2 2 2 2 2 2 2 2 2 1 1 1 1 1
1 2 2 2 2 2 2 2 2 1 1 1 1 2 1 1 2 2 2 2 2 2 2 2 2 1 1 1 1 1
1 2 2 2 1 1 2 2 2 2 2 2 2 2 2 2 2 2 1 1 1 2 2 2 2 2 2 2 2 1
1 2 2 2 1 1 2 2 2 2 2 2 2 1 1 1 2 2 1 1 1 2 2 1 1 1 1 2 2 1
1 2 2 2 1 1 2 2 2 2 1 1 2 1 1 1 2 2 2 2 2 2 2 1 1 1 1 2 2 1
1 2 2 2 2 2 2 2 2 2 1 1 2 2 2 2 2 1 1 2 2 2 2 2 2 2 2 2 2 1
1 1 1 2 1 1 1 1 2 2 1 1 2 2 2 2 2 1 1 2 2 2 1 1 1 1 2 1 1 1
1 1 1 2 1 1 1 1 2 2 2 2 2 1 1 1 2 1 1 2 2 2 1 1 1 1 2 1 1 1
1 2 2 2 1 1 1 1 2 2 2 2 2 1 1 1 2 2 2 2 2 2 2 2 2 2 2 2 2 1
1 1 1 1 1 1 1 1 1 1 1 1 1 1 1 1 1 1 1 1 1 1 1 1 1 1 1 1 1 1